10
7
XXX..XXXXX
XX...MX.XX
XXX..XXX.X
XM.H.....X
XXX..XXX.X
XXX...XXTX
XXXX..XXXX
